NO       ./resources/assets/redwall.xpm
SO    ./resources/assets/mossy.xpm
WE   ./resources/assets/colorstone.xpm
EA ./resources/assets/bluestone.xpm

F     69, 17, 25 
C   56, 65, 77

1111111111111111111111111
1000000000000000000000001
1011111111111111111111101
1001000001100000000000001
1011000001100000000000001
1001000001100000111111111
1111011111101111100000001
1000000000000000101010101
1111011111111111101010101
1100000000000000100000001
1000000000000000101010101
11000000N0000000111111111
1111011111101111100000001
1111111111111111111111111